help - Anleitung
poly - Menü der Polymensa
trailer - Menü des Foodtrailers
clausius - Menü der CLAusiusbar
fusion - Menü der Fusionmensa
riceup - Menü vom Rice Up!
tannenbar - Menü der Tannenbar
foodlab - Menü des Foodlab
grill - Menü vom food market grill bbQ
pizzapasta - Menü vom food market pizza pasta
green -  Menü food market green day
dozentenfoyer - Menü des Dozentenfoyers
uni - Mittags obere Uni, abends untere Uni
uniunten - UZH Untere Mensa a
unioben - UZH Obere Mensa b
lichthof - UZH Lichthof Rondell
irchel - UZH Irchel
tierspital - UZH Tierspital
zahnarzt - UZH Zentrum für Zahnmedizin
platte - UZH Plattenstrasse
raemi - UZH Rämi 59 (vegan)
zhdk - ZHDK Toni-Areal
klaras - Menü von Klara's Kitchen
hotpasta - Öffnungszeiten Hot Pasta
beersnmore - Öffnungszeiten Beers'n More
feedback - Was hältste von mir?
how - So funktioniere ich
polysnack - polysnack
gessbar - G-ESSbar
alumni - Alumni quattro Lounge
unipoint - Öffnungszeiten Döner Unipoint
coop - Öffnungszeiten coop Haldenbach
buchmann - Öffnungszeiten Cafe und Beck Buchmann
lemongrass - Öffnungszeiten The Lemon Grass
aessbar - Öffnungszeiten Äss-Bars Zentrum & Höngg
